na	nɑ	ㄋㄚ
ne	nɯ̯ʌ	ㄋㄜ
ni	ni	ㄋㄧ
nu	nu	ㄋㄨ
nü	ny	ㄋㄩ
nai	naɪ̯	ㄋㄞ
nan	nan	ㄋㄢ
nao	nɑʊ̯	ㄋㄠ
nei	neɪ̯	ㄋㄟ
nen	nən	ㄋㄣ
nie	niɛ	ㄋㄧㄝ
nin	nin	ㄋㄧㄣ
niu	ni̯ɤʊ̯	ㄋㄧㄡ
nou	nɤʊ̯	ㄋㄡ
nuo	nu̯ɔ	ㄋㄨㄛ
nüe	ny̯œ	ㄋㄩㄝ
nang	nɑŋ	ㄋㄤ
neng	nəŋ	ㄋㄥ
nian	niɛn	ㄋㄧㄢ
niao	ni̯ɑʊ̯	ㄋㄧㄠ
ning	niŋ	ㄋㄧㄥ
nong	nʊŋ	ㄋㄨㄥ
nuan	nu̯an	ㄋㄨㄢ
niang	ni̯ɑŋ	ㄋㄧㄤ
