da	tɑ	ㄉㄚ
de	tɯ̯ʌ	ㄉㄜ
di	ti	ㄉㄧ
du	tu	ㄉㄨ
dai	taɪ̯	ㄉㄞ
dan	tan	ㄉㄢ
dao	tɑʊ̯	ㄉㄠ
dei	teɪ̯	ㄉㄟ
den	tən	ㄉㄣ
die	tiɛ	ㄉㄧㄝ
diu	ti̯ɤʊ̯	ㄉㄧㄡ
dou	tɤʊ̯	ㄉㄡ
dui	tu̯eɪ̯	ㄉㄨㄟ
dun	tu̯ən	ㄉㄨㄣ
duo	tu̯ɔ	ㄉㄨㄛ
dang	tɑŋ	ㄉㄤ
deng	təŋ	ㄉㄥ
dian	tiɛn	ㄉㄧㄢ
diao	ti̯ɑʊ̯	ㄉㄧㄠ
ding	tiŋ	ㄉㄧㄥ
dong	tʊŋ	ㄉㄨㄥ
duan	tu̯an	ㄉㄨㄢ
